NO textures/north.xpm
SO textures/south.xpm
WE textures/west.xpm
EA textures/east.xpm

F 0,0,0
C 135,206,235

111111111111111111111
100000000010000000001
100000000000000000001
1000000000N0000000001
100000000000000000001
111111111111111111111
